NO ./textures/fish1.xpm
SO ./textures/fish2.xpm
WE ./textures/fish3.xpm
EA ./assets/main_menu_1.xpm
C 8,73,78
F 71,89,95
 
 
 
 
 
 
 
 
 
 
 
 
 
                111111111111 1111111111111
                 111111111111 1111111111111111         
                100000000011 1000000000001
                1001111100011 1000000000001       
                1001    100011 1000000000001
                10001 1100011 10000000001111
                10001   100011 10000000000011
                1000011100011 1000000000001
                10N100000011 1000000000001 
                101000000011 1000000000001
                100000000011 1000000000001
                111111111111 1111111111111
 
 
 
 
 
 
 
 
 
 
 
 
 
 
 
 
 
