NO ./textures/north.xpm
SO ./textures/duck.xpm
WE ./textures/logo_cub3d.xpm
EA ./textures/cobblestone.xpm
C 88,212,255
F 0,150,0
 11111111111111111
1N1
 1
