NO ./textures/north.xpm
SO ./textures/duck.xpm
WE ./textures/logo_cub3d.xpm
EA ./textures/cobblestone.xpm
C 88,212,255
F 0,150,0
 
 
 
 
 
 
 
 
 
 
 
 
 
                 11111111111111111111
                100000E000000000000011
                10011111000000000000011  
                1001    100000000000011
                10001 1100000000000011 
                111111111111111111111
