NO ./textures/path_to_the_north_texture
SO ./textures/path_to_the_south_texture
WE ./textures/path_to_the_west_texture
EA ./textures/path_to_the_east_texture
F 20,100,0
C 225,30,0
1111111111111111111111111
1N00000000110000000000001
1111111111111111111111111