NO ./textures/path_to_the_north_texture.xpm
SO ./textures/path_to_the_south_texture.xpm
WE ./textures/path_to_the_west_texture.xpm
EA ./textures/path_to_the_east_texture.xpm
F 88,212,255
C 225,30,0
 
 
 
 
 
 
 
 
 
 
 
 
 
                111111111111 1111111111111
                 111111111111 1111111111111111         
                100000000011 1000000000001
                1001111100011 1000000N00001       
                1001    100011 1000000000001
                10001 1100011 10000000001111
                10001   100011 10000000000011
                1000011100011 1000000000001
                100000000011 1000000000001 
                100000000011 1000000000001
                100000000011 1000000000001
                111111111111 1111111111111
 
 
 
 
 
 
 
 
 
 
 
 
 
 
 
 
 
